"000000000000000000000000000000000000000000000000000000000000000000000000000000000000000000000000000000000000000000000000000000000000000000000000000000",
"0                                                                                                                                                    0",
"0                                                                                                                                                    0",
"0                                                                                                                                                    0",
"0                                                                       k  kkkkkkkkk                                                                 0",
"0                                                                                k      k                 k                             k            0",
"0                                                                    kkkkkkkkk   k        k                                        k        cccccccc 0",
"0                                                                             k  k                    k       k                k            cccccccc 0",
"0                                                                                k           k    k                        k                kkkkkkkk 0",
"0                                                          kk             kkkkkkkk                                      k                            0",
"0                                                    kk          k    k                                            k                                 0",
"0                                         kkkkkkk                kkkkkk                                                                              0",
"0                                         k                                                                                                          0",
"0                                         k              k           k          k        k      k            k             k         k         k     0",
"0      kkkk   k    k   k   k   k kkkkkkkkkkkkkkkkkkkkkkkkkkkkkkkkkkkkkkkkkkkkkkkkkkkkkkkkkkkkkkkkkkkkkkkkkkkkkkkkkkkkkkkkkkkkkkkkkkkkkkkkkkkkkkkkkkkk0",
"0         k                      k                                                                                                                   0",
"0   k     k                      k                                                                     kkk   kkk   kkk  kkk     kkkkk  kkk  kkk      0",
"0         k                      k                                                                    k   k k   k k   k k  k    k     k   k k  k     0",
"0        kk                      k                                                                    k     k   k k   k k  k    k     k   k k k      0",
"0         k      k               k                                                                    k  kk k   k k   k k  k    k     k   k kk k     0",
"0 k       k                      k                                                                    k   k k   k k   k k  k    k   k k   k k  k     0",
"0         k   k       k          k                                                                     kkk   kkk   kkk  kkk      kkk   kkk  kkk      0",
"0       k k                      k                                                                                                                   0",
"0         k               k      k                                                                                                                   0",
"0 k       k   k              k   k                                                                                                                   0",
"0             k                  k                                                     0                                                             0",
"0kkkkkkkkkkkkkk                k k                                                     0                                                             0",
"0                         k      k                                                     0                                                             0",
"0                     k          k                                                     0                                                             0",
"0                                k                                                     0                                                             0",
"0           kkkkkk               k                                                     0                                                             0",
"0      k                         k             k                          kkkkkkkkkkk  0                                                             0",
"0                                k   0          k                        k           k 0                                                             0",
"0   k                            k   kkkkkkkkkkkkk                       k           k 0                                                             0",
"0                                k              k                   0000k kkk kkkk    k                                                              0",
"0       k   k    k          k    k             k                    0   k  kk   kk kk  k                                                             0",
"0       kkkkk    kkkkkkkkkkkk                                     00     k k  k     kk k                                                             0",
"0                                      k                         0       k  kk   kkk k k                                                             0",
"0                                kkkkkkk                         0       kkkkkkkk k   k                                                              0",
"0                            k   k      0000000kkkkkkkkkkkkkkkkkk        k k k k k   k                                                               0",
"0        kk   kkk  k       k     k                                      k kkkkkkk   k                                                                0",
"0                  kkkkkkkkk     k                                      k         kk                                                                 0",
"0    k                    k      k                                      k     kkkk                                                                   0",
"0                         k      k                                       kkkkk                                                                       0",
"0                         k      k                                                                                                                   0",
"0  k  kkkkkkkkkkkkkkkkkkkkk      k                                                                                                                   0",
"0                                k                                                                                                                   0",
"0    k                     k     k                                                                                                                   0",
"0    kkkkkkkkkkkkkkkkkkkkkkk     k                                                                                                                   0",
"0                                k                                                                                                                   0",
"0                             k  k                                                                                                                   0",
"0                                k                                                                                                                   0",
"0                         kkk    k                                                                                                                   0",
"0            kkkkkkkkkkkk        k                                                                                                                   0",
"0                       k        k                                                                                                                   0",
"0                       k        k                                                                                                                   0",
"0       kkkkkkkkkkkkk   k        k                                                                                                                   0",
"0                       k        k                                                                                                                   0",
"0             kkkkkkkkkkk        k                                                                                                                   0",
"0                                k                                                                                                                   0",
"0                                k                                                                                                                   0",
"0        k   k                   k                                                                                                                   0",
"0                                k                                                                                                                   0",
"0              kk                k                                                                                                                   0",
"0                                k                                                                                                                   0",
"0                                k                                                                                                                   0",
"0                  kk            k                                                                                                                   0",
"0                                k                                                                                                                   0",
"0                                k                                                                                                                   0",
"0          kkkkk                 k                                                                                                                   0",
"0                                k                                                                                                                   0",
"0                 k  k           k                                                                                                                   0",
"0                                k                                                                                                                   0",
"0                    k           k                                                                                                                   0",
"0                k               k                                                                                                                   0",
"0            k                   k                                                                                                                   0",
"0        k                       k                                                                                                                   0",
"PPPPPPPPPPPPPPPPPPPPPPPPPPPPPPPPPPPPPPPPPPPPPPPPPPPPPPPPPPPPPPPPPPPPPPPPPPPPPPPPPPPPPPPPPPPPPPPPPPPPPPPPPPPPPPPPPPPPPPPPPPPPPPPPPPPPPPPPPPPPPPPPPPPPPP",
"PPPPPPPPPPPPPPPPPPPPPPPPPPPPPPPPPPPPPPPPPPPPPPPPPPPPPPPPPPPPPPPPPPPPPPPPPPPPPPPPPPPPPPPPPPPPPPPPPPPPPPPPPPPPPPPPPPPPPPPPPPPPPPPPPPPPPPPPPPPPPPPPPPPPPP",
"PPPPPPPPPPPPPPPPPPPPPPPPPPPPPPPPPPPPPPPPPPPPPPPPPPPPPPPPPPPPPPPPPPPPPPPPPPPPPPPPPPPPPPPPPPPPPPPPPPPPPPPPPPPPPPPPPPPPPPPPPPPPPPPPPPPPPPPPPPPPPPPPPPPPPP"