"000000000000000000000000000000000000000000000000000000000000000000000000000000000000000000000000000000000000000000000000000000000000000000000000000000",
"0                                                                                                                                                    0",
"0                                                                                                                                                    0",
"0                                                                                                                                                    0",
"0                                                                                                                                                    0",
"0                                                                                                                                                    0",
"0                                                                                                                                                    0",
"0                                                                                                                                                    0",
"0                                                                                                                                                    0",
"0                                                                                                                                                    0",
"0                                                                                                                                                    0",
"0                                                                                                                                                    0",
"0                                                                                                                                                    0",
"0                                                                                                                                                    0",
"0                                                                                                                                                    0",
"0                                                                                                                                                    0",
"0                                                                                                                                                    0",
"0                                                                                                                                                    0",
"0                                                                                                                                                    0",
"0                                                                                                                                                    0",
"0                                                                                                                                                    0",
"0     d  c  k  0  r  t  0                                                                                                                            0",
"0                                                                                                                                                    0",
"0                                                                                                                                                    0",
"0                                                                                                                                                    0",
"0                                                                                                                                                    0",
"0                                                                                                                                                    0",
"0                                                                                                                                                    0",
"0                                                                                                                                                    0",
"0                                                                                                                                                    0",
"0                                                                                                                                                    0",
"0                                                                                                                                                    0",
"0                                                                                                                                                    0",
"0                                                                                                                                                    0",
"0                                                                                                                                                    0",
"0                                                                                                                                                    0",
"0                                                                                                                                                    0",
"0                                                                                                                                                    0",
"0                                                                                                                                                    0",
"0                                                                                                                                                    0",
"0                                                                                                                                                    0",
"0                                                                                                                                                    0",
"0                                                                                                                                                    0",
"0                                                                                                                                                    0",
"0                                                                                                                                                    0",
"0                                                                                                                                                    0",
"0                                                                                                                                                    0",
"0                                                                                                                                                    0",
"0                                                                                                                                                    0",
"0                                                                                                                                                    0",
"0                                                                                                                                                    0",
"0                                                                                                                                                    0",
"0                                                                                                                                                    0",
"0                                                                                                                                                    0",
"0                                                                                                                                                    0",
"0                                                                                                                                                    0",
"0                                                                                                                                                    0",
"0                                                                                                                                                    0",
"0                                                                                                                                                    0",
"0                                                                                                                                                    0",
"0                                                                                                                                                    0",
"0                                                                                                                                                    0",
"0                                                                                                                                                    0",
"0                                                                                                                                                    0",
"0                                                                                                                                                    0",
"0                                                                                                                                                    0",
"0                                                                                                                                                    0",
"0                                                                                                                                                    0",
"0                                                                                                                                                    0",
"0                                                                                                                                                    0",
"0                                       k                                                                                                            0",
"0                                       k                                                                                                            0",
"0                                       k                                                                                                            0",
"0                                       k                                                                                                            0",
"0                                       k                                                                                                            0",
"PPPPPPPPPPPPPPPPPPPPPPPPPPPPPPPPPPPPPPPPPPPPPPPPPPPPPPPPPPPPPPPPPPPPPPPPPPPPPPPPPPPPPPPPPPPPPPPPPPPPPPPPPPPPPPPPPPPPPPPPPPPPPPPPPPPPPPPPPPPPPPPPPPPPPP",
"PPPPPPPPPPPPPPPPPPPPPPPPPPPPPPPPPPPPPPPPPPPPPPPPPPPPPPPPPPPPPPPPPPPPPPPPPPPPPPPPPPPPPPPPPPPPPPPPPPPPPPPPPPPPPPPPPPPPPPPPPPPPPPPPPPPPPPPPPPPPPPPPPPPPPP",
"PPPPPPPPPPPPPPPPPPPPPPPPPPPPPPPPPPPPPPPPPPPPPPPPPPPPPPPPPPPPPPPPPPPPPPPPPPPPPPPPPPPPPPPPPPPPPPPPPPPPPPPPPPPPPPPPPPPPPPPPPPPPPPPPPPPPPPPPPPPPPPPPPPPPPP",